11111111111111111111
10001100000C10000011
100000PE000110000001
10010000000011000011
10000000000000000001
10000000000000000001
10000000000000010001
11111111111111111111
