111111111111111111111111111111111111111111111111111111111111
10001100000C100000111111111111111111111111111111111111111111
10001100000C100000111111111111111111111111111111111111111111
10000000E001000000111001001111001100001110010011110011000011
100100111100110000111001001111001100001110010011110011000011
1000X0101000000000011001001111001100001110010011110011000011
100000111100000000011001001111001100001110010011110011000011
1X000000000C000000011001001111001100001110010011110011000011
11X000000000000000011001001111001100001110010011110011000011
1X0000000X00000000011001001111001100001110010011110011000011
1X000X00C000000000011001001111001100001110010011110011000011
1X0000000000000000011001001111001100001110010011110011000011
1X000000C00C00X000011001001111001100001110010011110011000011
1X0000000000000000111001001111001100001110010011110011000011
111111100000000011111001001111001100001110010011110011000011
111111110000011111111001001111001100001110010011110011000011
100000000001000000111001001111001100001110010011110011000011
100100111100110000111001001111001100001110010011110011000011
1000X0101000000000011001001111001100001110010011110011000011
100000111100000000011001001111001100001110010011110011000011
1X000000000C000000P11001001111001100001110010011110011000011
11X000000000000000011001001111001100001110010011110011000011
1X0000000X00000000011001001111001100001110010011110011000011
1X000X00C000000000011001001111001100001110010011110011000011
1X0000000000000000011001001111001100001110010011110011000011
1X000000C00C00X000011001001111001100001110010011110011000011
1X0000000000000000111001001111001100001110010011110011000011
111111100000000011111001001111001100001110010011110011000011
111111111111111111111111111111111111111111111111111111111111