11111111111111111111
10001100000C10000011
10000000E00100000011
10010011110011000011
1000X010100000000001
10000011110000000001
1X000000000C000000P1
11X00000000000000001
1X0000000X0000000001
1X000X00C00000000001
1X000000000000000001
1X000000C00C00X00001
1X000000000000000011
11111110000000001111
11111111111111111111