11111111111111111
11111111111111111
10000111000011001
1P011E00CC0100101
10000000000000001
11111111111111111
11111111111111111